8,16
1 0,1 5,3 5,3 4,4 4,4 1,6 1,6 10,3 10,3 8,1 8,1 13,2 13,2 14,7 14
3,3,3,3,3,3,3,3,3,3,3,3,3,3,3,3
2,2,2,2,2,2,3,3,2,2,2,2,2,2,3,3
3,3,3,3,3,2,3,3,2,3,3,3,3,2,2,3
3,3,3,3,2,2,3,3,2,2,2,3,3,3,2,3
3,2,2,2,2,3,3,3,3,3,2,3,3,3,2,3
3,2,3,3,3,3,3,3,3,3,2,3,3,3,2,3
3,2,2,2,2,2,2,2,2,2,2,3,3,3,2,3
3,3,3,3,3,3,3,3,3,3,3,3,3,3,2,3
